1111111111111111111111111111111111111111111111111
100000I00000000000C000000000000000000000000000001
10P0000000000000000000000000000000C00000000000001
1000000000000000000000000000000000000000000000001
1011110010111110011111000100000101111111010000101
10100010101000010100001001100011010000C1010000101
10000I1010000C01000000010111111101000001011C00101
10100010101000010100000101C111C101000001011100101
1011110C1C11111001C000010100100101110111010110101
10100110101E1100010000010100000101000001010011101
100C0010101001100100000101C0000101000001C10001101
101001101010001001000C100100000101000001010000101
101111001010000101111100C100000101000001010000101
10000000000000000000000000000000000000C0000000001
10000C0000000000000000I00000000000000000000C00001
100000000000000C0000000000000000C0000000000000001
1111111111111111111111111111111111111111111111111
