11111111111111
10C100000C0C1
10P0011111001
100011E000001
1111111111111
