1111111111111111
10010P100E000001
110C0C0100CCC001
10I0000000000001
1001110010001001
111C0001000C0001
1010000010001111
1111111111111111
