1111111111111
10C100I00C0C1
10P0011110001
100011E000001
1111111111111
